ـَا	aː
ـَي	aj
ـَو	aw
ب	b
د	d
ض	dˤ
ج	dʒ
ذ	ð
ظ	ðˤ
ف	f
ه	h
ح	ħ
ـِي	iː
ي	j
ك	k
ل	l
م	m
ن	n
ق	q
ر	r
س	s
ص	sˤ
ش	ʃ
ت	t
ط	tˤ
ث	θ
ـُو	uː
و	w
خ	x
غ	ɣ
ز	z
ء	ʔ
ع	ʕ
